year,crashes,driver,passenger,cyclist,pedestrian,fatalities
2008,555,320,112,20,138,590
2009,550,315,98,14,157,584
2010,530,303,99,13,141,556
2011,586,362,105,17,143,627
2012,553,309,103,14,163,589
2013,508,304,92,14,132,542
2014,523,295,80,11,170,556
2015,522,276,96,17,173,562
2016,570,330,89,17,166,602
2017,591,339,86,16,183,624
2018,524,276,95,17,175,563
2019,524,289,81,12,176,558
2020,550,304,86,18,179,587
2021,667,368,86,26,217,697
2022,646,379,103,16,191,689
2023,587,332,87,24,176,619
